011111111111
1CCCCCCCCCC1
1CCCPCCCCCC1
100CCC1CCCE1
111111111111
